NO ./assets/textures/north.xpm
SO ./assets/textures/south.xpm
WE ./assets/textures/west.xpm
EA ./assets/textures/east.xpm
F  100,100,100
C  200,200,200

1111111111
110D000D01
11D1111101
1001000101
100D0001N1
1111111111
