NO ./assets/textures/north.xpm
SO ./assets/textures/south.xpm
WE ./assets/textures/west.xpm
EA ./assets/textures/east.xpm

F 100,100,100
C 200,200,200

111111
120001
100201
100N01
100021
111111