NO ./assets/textures/north.xpm
SO ./assets/textures/south.xpm
WE ./assets/textures/west.xpm
EA ./assets/textures/east.xpm

F 35,25,20
C 15,20,35

11111111111111111111111111111
10000000000000000000000000001
10111111111D1111111111111D001
10100000000000000000000000201
10101111D11111111111D1111111
10100000000000000000000000001
10111D11111111111111111D1111
10100000000000000000000000001
101011111111D111111111111D11
10100200000000000000020000001
10111111111111111111111111101
10000000000N00000000000000001
11111111111111111111111111111