NO ./assets/textures/north.xpm
SO ./assets/textures/south.xpm
WE ./assets/textures/west.xpm
EA ./assets/textures/east.xpm

F 50,25,0
C 25,25,112

        1111111111111111111111111111111111111111
        1000000000000000000000000000000000000001
        1000111111111111111111111111111111100001
        100D100000000000000000000000000001D000 1
        1000100111111111111111111111110001000001
        1000100100000000000000000000010001000001
        1000100100111111111111111100010001000001
        1000100100100000000000001D001000100000 1
        1000100100100111111111110000100010000D 1
        1000100100100100000000110000100010000001
        1000100100100100111100110000100010000001
        1000100100100100100D00110000100010000001
        1000100100100100110000110000100010000001
        1000100100100100110000110000100010111111
        1000100100100100110000110000100010000001
        1000100100100100110000110000100010000001
        1000100100100100110000110000100010000001
        1000100100100100110000110000100010000001
        1000100100100100110000110000100010000001
        1000100100100100110000110000100010000001
        1000100100100100110000110000100010000001
        1000100100100100110000110000100D10000001
        1000100100100100110000110000100010000001
        1000100100100100110000110000100010000001
        1000100100100100110000110000100010000001
        1000100100100100110000110D00100010000001
        1000100100100100110000110000100010000001
        1000100100100100110000110000100010000001
        1000100100100100110000110000100010000001
        1000100100100100110000110000100010000001
        1000100100100100110000110000100010000001
        1000100100100100110000110000100010000001
        1000100100100100110000110000100010000001
        1000100100100100110000110000100010000001
        1000100100100100110000110000100010000001
        10001001001001001100001100D0100010000001
        1000100100100100110000110000100010000001
        1000100100100100110000110000100010000001
        1000100100100100110000110000100010000001
        1000100100100100110000110000100010000001
        1000100100100100110000110000100010000001
        1000100100100100110000110000100D10000001
        1000100100100100110000110000100010000001
        1000100100100100110000110000100010000001
        1000100100100100110000110000100010000001
        1000100100100100110000110000100010000001
        1000100100100100110000110000100010000001
        1000100100100100110000110000100010000001
        1000100100100D00110000110000100010000001
        10001001001000001100001100001D0010000001
        1000100100111111111111111111110010000001
        10001001000000000000000000000000100D0001
        1000100111111111111111111111111110000001
        10001000000000000000000000000000000D0001
        1000111111111111111111111111111111100001
        1000000000000000000N0000000000000000D001
        1111111111111111111111111111111111111111