NO ./assets/textures/north.xpm
SO ./assets/textures/south.xpm
WE ./assets/textures/west.xpm
EA ./assets/textures/east.xpm

F 15,10,10
C 5,5,10

1111111111111111111111111
1000000000000000000000001
1011111D111111111D1111101
1010000000000000000000101
1010111111D11D11111110101
1010100000000000000010101
101010111111D111111010101
1010100020000000020010101
1010111111111111111010101
1010000000000000000010101
1011111D11111111111D11101
1000000000000N0000000000D
1111111111111111111111111