NO ./assets/textures/north.xpm
SO ./assets/textures/south.xpm
WE ./assets/textures/west.xpm
EA ./assets/textures/east.xpm

F 50,40,30
C 35,40,50

11111111111111111111111111111111111111111
10000000000000000000000000000000000000001
10111111111111D11111111111D11111111111101
10100000000000000000000000000000000000101
10101111111111111D1111D11111111111111D101
10101000002000000000000000000200000010101
10101011111111111111111111111111111010101
10101010000000000000000000000000000010101
101010101111111D1111111D1111111111010101
101010100000000000000000000000000000D0101
10101011111111111111111111111111111110101
10101000000000000200000200000000000000101
10111111111D111111111111111111D111111D101
10100000000000000000000000000000000000101
10101111111111111111D11111111111111111101
10100000000020000000000000002000000000101
10111D1111111111111111111111111111D111101
10000000000000000N00000000000000000000001
11111111111111111111111111111111111111111