NO ./assets/textures/north.xpm
SO ./assets/textures/south.xpm
WE ./assets/textures/west.xpm
EA ./assets/textures/east.xpm

F 45,35,25
C 30,35,45

11111111111111111111111111111111111
10000000000000000000000000000000001
10111111111111111111111111111111101
10100000000000000000000000000000101
10101111111111111111111111111110101
10100000000200000000000200000000101
10101110111111111111111111110111101
10100000000000000000000000000000101
10101111111111D1D1D1111111111110101
10100000000000000000000000000000101
10101110111111111111111111110111101
10100000000200000000000200000000101
10101111111111111111111111111110101
10100000000000000N0000000000000101
10111111111111111111111111111111101
10000000000000000000000000000000001
11111111111111111111111111111111111