NO ./assets/textures/north.xpm
SO ./assets/textures/south.xpm
WE ./assets/textures/west.xpm
EA ./assets/textures/east.xpm
F  100,100,100
C  200,200,200

1111111111111111111111111111111111111111
1000000000000000000000000000000000000001
1010101010101010101010101010101010101001
1000100000100000100000100000100000100001
1010111110111110111110111110111110111001
1000000000000000000000000000000000000001
1111111111111111111111111111111111100001
1000000000000000000000000000000000100001
1011111111111111111111111111111110100001
1010000000000000000000000000000010100001
1010111111111111111111111111111010100001
1010100000000000000000000000001010100001
1010101111111111111111111111101010100001
1010100000000000000000000000001010100001
1010111111111111111111111111101010100001
1010000000000000000000000000000010100001
1011111111111111111111111111111110100001
1000000000000000000000000000000000100001
1111111111111111111111111111111111100001
1000000000000000000000000000000000000001
1010101010101010101010101010101010101001
1000100000100000100N00100000100000100001
1010111110111110111110111110111110111001
1000000000000000000000000000000000000001
1111111111111111111111111111111111111111
