NO ./assets/textures/north.xpm
SO ./assets/textures/south.xpm
WE ./assets/textures/west.xpm
EA ./assets/textures/east.xpm

F 30,25,20
C 25,30,40

1111111111111111111
1000100010001000101
1010101010101011101
1010101010101000001
101010D010101011111
1010100010D01000201
1011111110111110101
1000000000100010101
1111111D1010D010101
1000001010100010101
1011101010101110101
1000101010100000101
1110101011111111101
100010D010000000001
1111111111111N11111
1111111111111111111