NO ./assets/textures/north.xpm
SO ./assets/textures/south.xpm
WE ./assets/textures/west.xpm
EA ./assets/textures/east.xpm

F 40,35,30
C 25,30,40

1111111111111111111111111
1000000000000000000000001
1000000000000000000000001
1002000020000200002000001
1000000000000000000000001
1000000000000000000000001
111111111D1D1D1D1D1111111
1000000000000000000000001
1000000000000000000000001
1002000020000200002000001
1000000000000000000000001
1000000000000000000000001
111111111D1D1D1D1D1111111
1000000000000000000000001
1000000000000000000000001
1000000000N00000000000001
1000000000000000000000001
1000000000000000000000001
1111111111111111111111111