NO ./assets/textures/north.xpm
SO ./assets/textures/south.xpm
WE ./assets/textures/west.xpm
EA ./assets/textures/east.xpm

F 20,15,10
C 5,10,20

111111111111111
100000000000001
101111111111101
101000000000101
101011111110101
101010000010101
101010111D10101
101010100010101
101010101110101
101010100000101
1010101D1111101
101010200000101
101011111111101
101000000000001
10111111111N111
100000000000001
111111111111111