NO ./assets/textures/north.xpm
SO ./assets/textures/south.xpm
WE ./assets/textures/west.xpm
EA ./assets/textures/east.xpm

F 40,35,30
C 25,30,40

1111111111111
1D0D0D0D0D0D1
1111D1D1D1111
100000N000001
1111D1D1D1111
1D0D0D0D0D0D1
1111111111111