NO ./assets/textures/north.xpm
SO ./assets/textures/south.xpm
WE ./assets/textures/west.xpm
EA ./assets/textures/east.xpm

F 35,30,25
C 20,25,35

111111111111111111111
100000000000000000001
100000000000000000001
100020000200002000001
100000000000000000001
100000000000000000001
100002000000000200001
100000000000000000001
100000000N00000000001
100000000000000000001
100002000000000200001
100000000000000000001
100000000000000000001
100020000200002000001
100000000000000000001
100000000000000000001
111111111111111111111